34
8
0 0 0 0 0 0 0 0 0 0 0 0 0 0 0 0 0 0 0 0 0 0 0 0 0 0 0 0 0 0 0 0 0 0 
0 0 0 0 0 0 0 0 0 0 0 0 0 0 0 0 0 0 0 0 0 0 0 0 0 0 0 0 0 0 0 0 0 0 
0 0 0 0 0 0 0 0 0 0 0 0 0 0 0 0 0 0 0 0 0 0 0 0 0 0 0 0 0 0 0 0 0 0 
6 8 9 10 23 0 0 0 0 0 0 0 0 0 15 0 0 0 0 20 0 0 0 0 0 0 0 0 0 0 0 0 0 0 
11 11 11 11 22 0 0 0 0 0 0 0 0 34 36 36 36 36 36 35 0 0 0 0 0 0 0 0 0 0 0 0 0 0 
2 3 1 4 22 0 0 0 0 0 0 0 0 37 18 18 19 18 18 38 0 0 0 0 0 0 0 0 0 0 0 0 0 0 
26 26 26 26 26 26 26 26 26 26 25 0 0 37 18 18 19 18 18 38 0 0 0 0 0 0 0 0 0 0 0 0 0 0 
13 14 13 13 13 13 14 13 13 13 28 0 0 37 18 18 19 18 18 38 0 0 0 0 0 0 0 0 0 0 0 0 0 0 
