11
8
0 0 0 0 0 0 0 0 0 0 0 
0 0 0 0 0 0 0 0 0 0 0 
0 0 0 0 0 0 0 0 0 0 0 
7 8 9 10 23 0 0 0 0 0 0 
6 11 11 11 22 0 0 0 0 0 0 
2 3 1 4 21 0 0 0 0 0 0 
26 26 26 26 26 26 25 0 0 0 0 
13 14 13 13 13 13 28 0 0 0 0 
