80
10
0 0 0 0 0 0 0 0 0 0 0 0 0 0 0 0 0 0 0 0 0 0 0 0 6 0 0 0 0 0 0 0 0 0 0 0 0 0 0 0 0 0 0 0 0 0 0 0 0 0 0 0 0 0 0 0 0 0 0 0 0 0 0 0 0 0 0 0 0 0 0 0 0 0 0 0 0 0 0 0 
0 0 0 0 0 0 0 0 0 0 0 0 0 0 0 0 0 0 0 0 0 0 0 0 5 0 0 0 0 0 0 0 0 0 0 0 0 0 0 0 0 0 0 0 0 0 0 0 0 0 0 0 0 0 6 0 0 0 0 0 0 0 0 6 0 0 0 0 0 0 0 0 0 0 0 0 0 0 0 0 
0 0 0 0 0 0 0 0 0 0 0 0 0 0 0 0 0 0 0 0 0 0 0 0 16 17 0 0 0 0 0 0 0 0 0 0 0 0 0 0 0 0 0 0 0 0 0 0 0 0 0 0 0 0 5 0 0 0 0 0 4 0 0 5 0 0 0 0 0 0 0 0 0 0 0 0 0 0 0 0 
0 0 0 0 0 0 0 0 0 0 0 0 0 0 0 0 0 0 0 0 0 0 0 0 0 0 0 0 0 0 0 0 0 0 0 0 0 0 0 0 0 0 0 0 0 0 0 0 0 0 4 0 0 16 17 0 0 0 0 0 16 15 15 15 17 0 0 0 0 0 0 0 0 0 0 0 0 0 0 0 
0 0 0 0 0 0 0 0 0 0 0 0 0 0 0 0 0 0 0 0 0 0 0 0 0 0 0 0 0 0 0 0 0 0 0 0 0 0 0 0 0 0 0 0 6 0 0 0 0 16 17 0 0 0 0 0 0 0 0 0 20 23 23 23 21 0 0 0 0 0 0 0 0 0 0 0 0 0 0 0 
0 0 0 0 0 0 0 0 4 0 0 0 0 0 0 0 0 0 6 0 0 0 0 0 0 0 0 0 0 0 0 0 0 0 0 0 0 7 0 0 0 0 0 0 5 0 0 0 0 0 0 0 0 0 0 0 6 0 0 0 0 0 0 0 0 0 0 0 0 0 0 0 0 0 0 0 0 0 0 0 
0 0 6 0 0 0 0 0 16 15 18 2 14 14 14 14 3 19 15 17 0 0 0 0 0 0 0 6 0 0 0 0 0 0 0 0 0 16 18 2 14 8 3 15 15 15 17 0 0 0 0 0 0 0 0 0 16 17 0 0 7 4 0 6 0 0 0 0 0 0 0 0 0 0 0 0 0 0 6 0 
7 0 5 0 7 0 0 0 20 23 23 10 8 8 8 8 11 23 23 21 0 0 0 0 0 7 0 5 0 7 0 0 0 0 0 0 16 23 23 9 8 8 12 23 23 1 21 0 0 0 0 0 0 0 0 0 0 0 0 0 16 15 15 17 0 0 4 0 0 0 0 0 0 0 0 0 0 0 5 0 
16 15 15 15 15 15 17 0 20 23 23 9 8 8 8 8 12 23 23 21 0 0 0 0 0 16 15 15 15 17 0 0 0 0 4 16 1 23 23 23 22 22 23 23 23 1 21 0 0 0 0 0 0 0 0 0 0 0 0 0 20 1 1 21 0 0 16 18 2 8 8 8 14 8 8 3 19 16 15 15 
20 1 1 1 1 1 21 0 20 23 23 23 22 22 22 22 23 23 23 21 0 0 0 0 0 20 1 1 1 21 0 0 0 0 16 1 1 1 23 1 1 1 1 23 23 1 21 0 0 0 0 0 0 0 0 0 0 0 0 0 1 1 1 21 0 0 20 23 10 8 8 8 8 8 8 11 23 23 23 23 
