20
15
2 0 0 0 0 0 0 0 0 0 0 0 0 0 0 0 2 0 0 12 
8 8 8 8 8 8 8 8 8 8 8 8 8 8 8 8 8 0 0 12 
0 0 0 0 0 0 2 0 0 0 0 0 0 0 0 0 0 0 2 12 
0 0 0 0 0 0 9 8 8 8 8 8 8 8 8 8 8 8 8 1 
0 0 0 0 8 0 0 0 0 0 0 0 0 0 0 0 0 0 0 12 
0 0 8 0 0 0 0 0 0 0 0 0 0 0 0 0 0 0 0 12 
2 0 0 0 0 0 0 0 0 0 0 0 0 0 0 2 0 0 0 12 
8 8 8 8 8 8 8 8 8 8 8 8 8 8 8 8 0 0 0 12 
0 0 0 0 0 0 0 0 0 0 0 0 0 0 0 0 10 0 0 12 
0 0 0 0 0 0 0 2 0 0 0 0 0 0 0 0 0 0 2 12 
0 0 0 0 0 0 0 9 8 8 8 8 8 8 8 8 8 8 8 1 
0 0 0 0 0 8 0 0 0 0 0 0 0 0 0 0 0 0 0 12 
0 0 0 8 0 0 0 0 0 0 0 0 0 0 0 0 0 0 0 12 
2 0 0 0 0 0 0 0 0 0 0 0 0 0 0 0 0 0 2 12 
8 8 8 8 8 8 8 8 8 8 8 8 8 8 8 8 8 8 8 1 
